{
    "name": "Level 1",
    "background": "background",
    "scrollSpeed": 20,
    "music": "music",

    "legend": {
        "0": "empty",
        "3": "obstacle1",
        "5": "obstacle2"
        },
    "map": [
        "0 0 0 0 0 0 0 0 0 0 0 0 0 0 0 0 0 0 0 0 0 0 0 0 0 0 0 0 0 0 0 0 0",
        "0 0 0 0 0 0 0 0 0 0 0 0 3 3 0 0 0 3 3 0 0 0 0 0 0 0 0 0 0 0 0 0 0",
        "0 0 0 0 0 0 0 0 0 0 0 3 0 0 3 0 3 0 0 3 0 0 0 0 0 0 0 0 0 0 0 0 0",
        "0 0 0 0 0 0 0 0 0 0 0 3 0 0 0 5 0 0 0 3 0 0 0 0 0 0 0 0 0 0 0 0 0",
        "0 0 0 0 0 0 0 0 0 0 0 3 0 0 0 0 0 0 0 3 0 0 0 0 0 0 0 0 0 0 0 0 0",
        "0 0 0 0 0 0 0 0 0 0 0 0 3 0 0 0 0 0 3 0 0 0 0 0 0 0 0 0 0 0 0 0 0",
        "0 0 0 0 0 0 0 0 0 0 0 0 3 0 0 0 0 0 3 0 0 0 0 0 0 0 0 0 0 0 0 0 0",
        "0 0 0 0 0 0 0 0 0 0 0 0 0 3 0 0 0 3 0 0 0 0 0 0 0 0 0 0 0 0 0 0 0",
        "0 0 0 0 0 0 0 0 0 0 0 0 0 0 3 0 3 0 0 0 0 0 0 0 0 0 0 0 0 0 0 0 0",
        "0 0 0 0 0 0 0 0 0 0 0 0 0 0 0 3 0 0 0 0 0 0 0 0 0 0 0 0 0 0 0 0 0",
        "0 0 0 0 0 0 0 0 0 0 0 0 0 0 0 0 0 0 0 0 0 0 0 0 0 0 0 0 0 0 0 0 0",
        "0 0 0 0 0 0 0 0 0 0 0 0 0 0 0 0 0 0 0 0 0 0 0 0 0 0 0 0 0 0 0 0 0"
    ],
    "waves": [
        {
            "spawnLength": 15,
            "posX": 5,
            "enemies": [
                    { "type": "enemy1", "count": 34}
            ]
        }
    ]
}